(null)
24
24
1532500
1
0
000000000000000000000000
000000000000000000000000
000000000000000000000000
000000000000000000000000
000000000000000000000000
000000000000000000000000
000000000000000000000000
000000000000000000000000
000000000000000000000000
000000000000000000000000
000000000000000000000000
000000000000000000000000
000000000000000000000000
000000000000000000000000
000000000000000000000000
000000000000000000000000
000000000000000000000000
000000000000000000000000
000000000000000000000000
000000000000000000000000
000000000000000000000000
000000000000000000000000
000000000000000000000000
000000000000000000000000
12
12
4

Two World
24
24
338100
1
1
000000000000000000000000
000000000000000000000000
000000000000000000000000
000000000000000000000000
000000000000000000000000
000000000000000000000000
000000000000000000000000
000000000000000000000000
000000000000000000000000
000000000000000000000000
000000000000000000000000
000000000000000000000000
111111111111111111111111
111111111111111111111111
111111111111111111111111
111111111111111111111111
111111111111111111111111
111111111111111111111111
111111111111111111111111
111111111111111111111111
111111111111111111111111
111111111111111111111111
111111111111111111111111
111111111111111111111111
10
16
3

Four Blocks
24
24
116550
1
0
000000000100000001000000
000000000100000001000000
000000000100000001000000
000000000100000001000000
000000000100000001000000
000000000100000001000000
111111111100000001000000
000000000000000001000000
000000000000000001000000
000000000000000001111111
000000000000000000000000
000000000000000000000000
000000000000000000000000
000000000000000000000000
111111100000000000000000
000000100000000000000000
000000100000000000000000
000000100000001111111111
000000100000001000000000
000000100000001000000000
000000100000001000000000
000000100000001000000000
000000100000001000000000
000000100000001000000000
12
12
4

Cross Road
24
24
224550
1
1
000000001111111100000000
000000001111111100000000
000000001111111100000000
000000001111111100000000
000000001111111100000000
000000001111111100000000
000000001111111100000000
000000001111111100000000
111111111111111111111111
111111111111111111111111
111111111111111111111111
111111111111111111111111
111111111111111111111111
111111111111111111111111
111111111111111111111111
111111111111111111111111
000000001111111100000000
000000001111111100000000
000000001111111100000000
000000001111111100000000
000000001111111100000000
000000001111111100000000
000000001111111100000000
000000001111111100000000
12
14
2
