(null)
30
30
3287400
1
0
000000000000000000000000000000
000000000000000000000000000000
000000000000000000000000000000
000000000000000000000000000000
000000000000000000000000000000
000000000000000000000000000000
000000000000000000000000000000
000000000000000000000000000000
000000000000000000000000000000
000000000000000000000000000000
000000000000000000000000000000
000000000000000000000000000000
000000000000000000000000000000
000000000000000000000000000000
000000000000000000000000000000
000000000000000000000000000000
000000000000000000000000000000
000000000000000000000000000000
000000000000000000000000000000
000000000000000000000000000000
000000000000000000000000000000
000000000000000000000000000000
000000000000000000000000000000
000000000000000000000000000000
000000000000000000000000000000
000000000000000000000000000000
000000000000000000000000000000
000000000000000000000000000000
000000000000000000000000000000
000000000000000000000000000000
15
15
4

Walls
30
30
1290100
0
0
111111111111111111111111111111
111111111111111111111111111111
111111111111111111111111111111
111111111111111111111111111111
111111111111111111111111111111
111111111111111111111111111111
111111111111111111111111111111
111111111111111111111111111111
111111111111111111111111111111
111111111111111111111111111111
111111111111111111111111111111
111111111111111111111111111111
111111111111111111111111111111
111111111111111111111111111111
111111111111111111111111111111
111111111111111111111111111111
111111111111111111111111111111
111111111111111111111111111111
111111111111111111111111111111
111111111111111111111111111111
111111111111111111111111111111
111111111111111111111111111111
111111111111111111111111111111
111111111111111111111111111111
111111111111111111111111111111
111111111111111111111111111111
111111111111111111111111111111
111111111111111111111111111111
111111111111111111111111111111
111111111111111111111111111111
15
15
4

Two World
30
30
800900
1
1
000000000000000000000000000000
000000000000000000000000000000
000000000000000000000000000000
000000000000000000000000000000
000000000000000000000000000000
000000000000000000000000000000
000000000000000000000000000000
000000000000000000000000000000
000000000000000000000000000000
000000000000000000000000000000
000000000000000000000000000000
000000000000000000000000000000
000000000000000000000000000000
000000000000000000000000000000
000000000000000000000000000000
111111111111111111111111111111
111111111111111111111111111111
111111111111111111111111111111
111111111111111111111111111111
111111111111111111111111111111
111111111111111111111111111111
111111111111111111111111111111
111111111111111111111111111111
111111111111111111111111111111
111111111111111111111111111111
111111111111111111111111111111
111111111111111111111111111111
111111111111111111111111111111
111111111111111111111111111111
111111111111111111111111111111
10
20
3

Four Blocks
30
30
416000
1
0
000000000000100000000100000000
000000000000100000000100000000
000000000000100000000100000000
000000000000100000000100000000
000000000000100000000100000000
000000000000100000000100000000
000000000000100000000100000000
000000000000100000000100000000
111111111111100000000100000000
000000000000000000000100000000
000000000000000000000100000000
000000000000000000000100000000
000000000000000000000111111111
000000000000000000000000000000
000000000000000000000000000000
000000000000000000000000000000
000000000000000000000000000000
111111111000000000000000000000
000000001000000000000000000000
000000001000000000000000000000
000000001000000000000000000000
000000001000000001111111111111
000000001000000001000000000000
000000001000000001000000000000
000000001000000001000000000000
000000001000000001000000000000
000000001000000001000000000000
000000001000000001000000000000
000000001000000001000000000000
000000001000000001000000000000
15
15
4

Cross Road
30
30
285000
1
1
000000000011111111110000000000
000000000011111111110000000000
000000000011111111110000000000
000000000011111111110000000000
000000000011111111110000000000
000000000011111111110000000000
000000000011111111110000000000
000000000011111111110000000000
000000000011111111110000000000
000000000011111111110000000000
111111111111111111111111111111
111111111111111111111111111111
111111111111111111111111111111
111111111111111111111111111111
111111111111111111111111111111
111111111111111111111111111111
111111111111111111111111111111
111111111111111111111111111111
111111111111111111111111111111
111111111111111111111111111111
000000000011111111110000000000
000000000011111111110000000000
000000000011111111110000000000
000000000011111111110000000000
000000000011111111110000000000
000000000011111111110000000000
000000000011111111110000000000
000000000011111111110000000000
000000000011111111110000000000
000000000011111111110000000000
13
15
2

SUN
30
30
519000
0
0
000000000000000000000000000000
011111111111111111111111111110
011111111111111111111111111110
011111111111111111111111111110
011111111111111111111111111110
011111111111111111111111111110
011111000000000000000000111110
011111011111111111111110111110
011111010000101101011010111110
011111010111101101001010111110
011111010000101101000010111110
011111011110101101010010111110
011111010000100001011010111110
011111011111111111111110111110
011111000000000000000000111110
011111111111111111111111111110
011111111111111111111111111110
011111111111111111111111111110
011111111111111111111111111110
011111111111111111111111111110
011111111111111111111111111110
011111111111111111111111111110
011111111111111111111111111110
011111111111111111111111111110
011111111111111111111111111110
011111111111111111111111111110
011111111111111111111111111110
011111111111111111111111111110
011111111111111111111111111110
000000000000000000000000000000
15
23
1
